CMD_NAME_BEGIN[cfg-delay-time1]CMD_NAME_END	CMD_FUNC[执行延时操作1]CMD_FUNC	ATTENTIONS[无1]ATTENTIONS	MARK[无1]MARK
CMD_NAME_BEGIN[cfg-delay-time2]CMD_NAME_END	CMD_FUNC[执行延时操作2]CMD_FUNC	ATTENTIONS[无2]ATTENTIONS	MARK[无2]MARK
CMD_NAME_BEGIN[cfg-delay-time3]CMD_NAME_END	CMD_FUNC[执行延时操作3]CMD_FUNC	ATTENTIONS[无3]ATTENTIONS	MARK[无3]MARK
CMD_NAME_BEGIN[cfg-delay-time4]CMD_NAME_END	CMD_FUNC[执行延时操作4]CMD_FUNC	ATTENTIONS[无4]ATTENTIONS	MARK[无4]MARK
CMD_NAME_BEGIN[cfg-delay-time5]CMD_NAME_END	CMD_FUNC[执行延时操作5]CMD_FUNC	ATTENTIONS[无5]ATTENTIONS	MARK[无5]MARK
CMD_NAME_BEGIN[cfg-delay-time6]CMD_NAME_END	CMD_FUNC[执行延时操作6]CMD_FUNC	ATTENTIONS[无6]ATTENTIONS	MARK[无6]MARK
CMD_NAME_BEGIN[cfg-delay-time7]CMD_NAME_END	CMD_FUNC[执行延时操作7]CMD_FUNC	ATTENTIONS[无7]ATTENTIONS	MARK[无7]MARK
CMD_NAME_BEGIN[cfg-delay-time8]CMD_NAME_END	CMD_FUNC[执行延时操作8]CMD_FUNC	ATTENTIONS[无8]ATTENTIONS	MARK[无8]MARK
CMD_NAME_BEGIN[cfg-delay-time9]CMD_NAME_END	CMD_FUNC[执行延时操作9]CMD_FUNC	ATTENTIONS[无9]ATTENTIONS	MARK[无9]MARK
CMD_NAME_BEGIN[cfg-delay-time10]CMD_NAME_END	CMD_FUNC[执行延时操作10]CMD_FUNC	ATTENTIONS[无10]ATTENTIONS	MARK[无10]MARK
CMD_NAME_BEGIN[cfg-delay-time11]CMD_NAME_END	CMD_FUNC[执行延时操作11]CMD_FUNC	ATTENTIONS[无11]ATTENTIONS	MARK[无11]MARK
CMD_NAME_BEGIN[cfg-delay-time12]CMD_NAME_END	CMD_FUNC[执行延时操作12]CMD_FUNC	ATTENTIONS[无12]ATTENTIONS	MARK[无12]MARK
CMD_NAME_BEGIN[cfg-delay-time13]CMD_NAME_END	CMD_FUNC[执行延时操作13]CMD_FUNC	ATTENTIONS[无13]ATTENTIONS	MARK[无13]MARK
CMD_NAME_BEGIN[cfg-delay-time14]CMD_NAME_END	CMD_FUNC[执行延时操作14]CMD_FUNC	ATTENTIONS[无14]ATTENTIONS	MARK[无14]MARK
CMD_NAME_BEGIN[cfg-delay-time15]CMD_NAME_END	CMD_FUNC[执行延时操作15]CMD_FUNC	ATTENTIONS[无15]ATTENTIONS	MARK[无15]MARK
CMD_NAME_BEGIN[cfg-delay-time16]CMD_NAME_END	CMD_FUNC[执行延时操作16]CMD_FUNC	ATTENTIONS[无16]ATTENTIONS	MARK[无16]MARK
CMD_NAME_BEGIN[cfg-delay-time17]CMD_NAME_END	CMD_FUNC[执行延时操作17]CMD_FUNC	ATTENTIONS[无17]ATTENTIONS	MARK[无17]MARK
CMD_NAME_BEGIN[cfg-delay-time18]CMD_NAME_END	CMD_FUNC[执行延时操作18]CMD_FUNC	ATTENTIONS[无18]ATTENTIONS	MARK[无18]MARK
CMD_NAME_BEGIN[cfg-delay-time19]CMD_NAME_END	CMD_FUNC[执行延时操作19]CMD_FUNC	ATTENTIONS[无19]ATTENTIONS	MARK[无19]MARK
CMD_NAME_BEGIN[cfg-delay-time20]CMD_NAME_END	CMD_FUNC[执行延
时操作测试120]CMD_FUNC	ATTENTIONS[无特殊测试2
20]ATTENTIONS	MARK[无特殊测试20]MARK